Name	i5	i7
Torres-Padilla_custom_A1	GCGCATAT	CTGATCGT
Torres-Padilla_custom_A2	CTGTACCA	ACTCTCGA
Torres-Padilla_custom_A3	GAACGGTT	TGAGCTAG
Torres-Padilla_custom_A4	ACCGGTTA	GAGACGAT
Torres-Padilla_custom_A5	CGATGTTC	CTTGTCGA
Torres-Padilla_custom_A6	CTACAAGG	TTCCAAGG
Torres-Padilla_custom_A7	AAGCCTGA	CGCATGAT
Torres-Padilla_custom_A8	ACGAGAAC	ACGGAACA
Torres-Padilla_custom_A9	CTCGTTCT	CGGCTAAT
Torres-Padilla_custom_A10	TGGAAGCA	ATCGATCG
Torres-Padilla_custom_A11	AGTCGAAG	GCAAGATC
Torres-Padilla_custom_A12	AACAGGTG	GCTATCCT
Torres-Padilla_custom_B1	CGTGTGAT	TACGCTAC
Torres-Padilla_custom_B2	TCTTACGG	TGGACTCT
Torres-Padilla_custom_B3	AAGGCGTA	AGAGTAGC
Torres-Padilla_custom_B4	TAACGTCG	ATCCAGAG
Torres-Padilla_custom_B5	TCGTGCAT	GACGATCT
Torres-Padilla_custom_B6	CAATCAGG	AACTGAGC
Torres-Padilla_custom_B7	ACTCCTAC	CTTAGGAC
Torres-Padilla_custom_B8	CTCCTAGT	GTGCCATA
Torres-Padilla_custom_B9	AGCTAGTG	GAATCCGA
Torres-Padilla_custom_B10	CAAGTCGT	TCGCTGTT
Torres-Padilla_custom_B11	TACACACG	TTCGTTGG
Torres-Padilla_custom_B12	AGGTCAAC	AAGCACTG
Torres-Padilla_custom_C1	GATGGAGT	CCTTGATC
Torres-Padilla_custom_C2	CCACATTG	GTCGAAGA
Torres-Padilla_custom_C3	GTCTGCAA	ACCACGAT
Torres-Padilla_custom_C4	TTGGACTG	GATTACCG
Torres-Padilla_custom_C5	CTGAACGT	GCACAACT
Torres-Padilla_custom_C6	CAGACGTT	GCGTCATT
Torres-Padilla_custom_C7	GACCGATA	ATCCGGTA
Torres-Padilla_custom_C8	ATAGAGCG	CGTTGCAA
Torres-Padilla_custom_C9	GAGCAATC	GTGAAGTG
Torres-Padilla_custom_C10	CACACATC	CATGGCTA
Torres-Padilla_custom_C11	AGATTGCG	ATGCCTGT
Torres-Padilla_custom_C12	AGCTACCA	CAACACCT
Torres-Padilla_custom_D1	AGCCTATC	TGTGACTG
Torres-Padilla_custom_D2	GATCCACT	GTCATCGA
Torres-Padilla_custom_D3	ACGTCCAA	AGCACTTC
Torres-Padilla_custom_D4	GACGTCAT	GAAGGAAG
Torres-Padilla_custom_D5	CCAACTTC	GTTGTTCG
Torres-Padilla_custom_D6	GTGGTATG	CGGTTGTT
Torres-Padilla_custom_D7	GTCAACAG	ACTGAGGT
Torres-Padilla_custom_D8	ACATGCCA	TGAAGACG
Torres-Padilla_custom_D9	ATGGCGAT	GTTACGCA
Torres-Padilla_custom_D10	CTTCGCAA	AGCGTGTT
Torres-Padilla_custom_D11	GACGAACT	GATCGAGT
Torres-Padilla_custom_D12	TACTGCTC	ACAGCTCA
Torres-Padilla_custom_E1	TGAGCTGT	GAGCAGTA
Torres-Padilla_custom_E2	ACTCGATC	AGTTCGTC
Torres-Padilla_custom_E3	AACACGCT	TTGCGAAG
Torres-Padilla_custom_E4	TGCGTAAC	ATCGCCAT
Torres-Padilla_custom_E5	CGTCTTCA	TGGCATGT
Torres-Padilla_custom_E6	ACCTCAGT	CTGTTGAC
Torres-Padilla_custom_E7	AACAACCG	CATACCAC
Torres-Padilla_custom_E8	CGAACAAC	GAAGTTGG
Torres-Padilla_custom_E9	CTTCCTTC	ATGACGTC
Torres-Padilla_custom_E10	GAAGTGCT	TTGGACGT
Torres-Padilla_custom_E11	TCGATGAC	AGTGGATC
Torres-Padilla_custom_E12	CAGTCACA	GATAGGCT
Torres-Padilla_custom_F1	AGGTGTTG	TGGTAGCT
Torres-Padilla_custom_F2	ACAGGCAT	CGCAATCT
Torres-Padilla_custom_F3	TAGCCATG	GATGTGTG
Torres-Padilla_custom_F4	CACTTCAC	GATTGCTC
Torres-Padilla_custom_F5	TTGCAACG	CGCTCTAT
Torres-Padilla_custom_F6	TACCGGAT	TATCGGTC
Torres-Padilla_custom_F7	AATGACGC	AACGTCTG
Torres-Padilla_custom_F8	AGTTGTGC	ACGTTCAG
Torres-Padilla_custom_F9	CGGTAATC	CAGTCCAA
Torres-Padilla_custom_F10	ATCGTGGT	TTGCAGAC
Torres-Padilla_custom_F11	TCTTCGAC	CAATGTGG
Torres-Padilla_custom_F12	GATCAAGG	ACTCCATC
Torres-Padilla_custom_G1	CAGTGCTT	GTTGACCT
Torres-Padilla_custom_G2	CCAACGAA	CGTGTGTA
Torres-Padilla_custom_G3	AACAGCGA	ACGACTTG
Torres-Padilla_custom_G4	TCGGATTC	CACTAGCT
Torres-Padilla_custom_G5	TATGGCAC	ACTAGGAG
Torres-Padilla_custom_G6	GTCCTAAG	GTAGGAGT
Torres-Padilla_custom_G7	GCTCAGTT	CCTGATTG
Torres-Padilla_custom_G8	AGATCGTC	ATGCACGA
Torres-Padilla_custom_G9	CTCTGGAT	CGACGTTA
Torres-Padilla_custom_G10	GCTACTCT	TACGCCTT
Torres-Padilla_custom_G11	AGAGTCCA	CCGTAAGA
Torres-Padilla_custom_G12	GTAGCGTA	ATCACACG
Torres-Padilla_custom_H1	AGGATAGC	CACCTGTT
Torres-Padilla_custom_H2	GATCTTGC	CTTCGACT
Torres-Padilla_custom_H3	CGATCGAT	TGCTTCCA
Torres-Padilla_custom_H4	ATTAGCCG	AGAACGAG
Torres-Padilla_custom_H5	TGTTCCGT	GTTCTCGT
Torres-Padilla_custom_H6	ATCATGCG	TCAGGCTT
Torres-Padilla_custom_H7	CCTTGGAA	CCTTGTAG
Torres-Padilla_custom_H8	TCGACAAG	GAACATCG
Torres-Padilla_custom_H9	ATCGTCTC	TAACCGGT
Torres-Padilla_custom_H10	CTAGCTCA	AACCGTTC
Torres-Padilla_custom_H11	TCGAGAGT	TGGTACAG
Torres-Padilla_custom_H12	ACGATCAG	ATATGCGC